1111111111111
1PCE000000001
1000000000001
11111111111
