NO ./textures/creeper.xpm
SO ./textures/creeper.xpm
WE ./textures/creeper.xpm
EA ./textures/creeper.xpm

F 0,0,0
C 0,100,0

1111111111111111111111111
1000000000000000000000001
1000000000000000000000001
1000000000000000000000001
1000000000000000000000001
1000000000000000000000001
1000000000000000000000001
1000000000000000000000001
1000000000000000000000001
1E00000000000000000000001
1111111111111111111111111