NO ./textures/umi.xpm
SO ./textures/umi.xpm
WE ./textures/umi.xpm
EA ./textures/umi.xpm

F 252,241,224
C 100,190,239

1111111111111111111111111
10000000000N0000000000001
1000000000000000000000001
1000000000000000000000001
1000000000000000000000001
1000000000000000000000001
1000000000000000000000001
1000000000000000000000001
1000000000000000000000001
1000000000000000000000001
1111111111111111111111111
