NO ./textures/1.xpm
SO ./textures/2.xpm
WE ./textures/3.xpm
EA ./textures/4.xpm

F 0,32,255
C 80,208,255

1111111111111111111111111
1000000000000000000000001
1000000000000000000000001
1000000000000000000000001
1000000000000000000000001
1000000000000000000000001
1000000000000000000000001
1000000000000000000000001
1000000000000000000000001
1E00000000000000000000001
1111111111111111111111111