11111111111
1P000000001
11111111111

