1111111111
1C001001C1
1001000011
1E0P000001
1111111111
