NO ./textures/1.xpm
SO ./textures/2.xpm
WE ./textures/3.xpm
EA ./textures/4.xpm

F 0,100,0
C 30,100,100

        1111111101111111111111111
        1000000000110000000000001
        1011000001110000000000001
        1001000000000000000000001
111111111001000001110000000000001
100000000011000001110111111111111
11110111111111011100000000001
11110111111111011101010010001
11000000110101011100000010001
10000000000000001100000010001
1000N000000000001101010010001
110000011101010111110111101111
11110111 1110101 101111010001
11111111 1111111 111111111111