NO ./textures/creeper.xpm
SO ./textures/creeper.xpm
WE ./textures/creeper.xpm
EA ./textures/creeper.xpm

F 220,100,0
C 255,30,0

111111111111111111111
1000000000110000000001111111111
10110000011100000000000000001
10010000000000000000000000001
111101111111111111111111111111
11110111111111011101010010001
11000000110101011100000010001
10000000000N00001101101111111
11000101101010010001
11111111111111111111111111111