1111111111111111111111111111111111
1000000000000000000000000000000001
1011111111111111111111111111111101
1E100010001000100010001000100011C1
1P10101010101010101010101010101001
1010101010101010101010101010101011
1010101010101010101010101010101011
1010101010101010101010101010101011
1010101010101010101010101010101011
1010101010101010101010101010101011
1010101010101010101010101010101011
1010101010101010101010101010101011
1000100010001000100010001000100011
1111111111111111111111111111111111
